R 640		  	320
EA pics/eagle.xpm

	NO pics/mondriansm.xpm
WE 	   pics/purplestone.xpm
	  SO      	pics/redbrick.xpm	
S	  pics/barrel.xpm			
F	100,100,100  	


C 0 , 50 , 50


        1111111111111111111111111
        1000000000110000000000001
        1011000001110000200020001
        1001000000000000000000001
111111111011000001110000010220001
100000000011000001110111110111111
11110111111111011100000010001
11110111111111011101010010001
11000000110101011100000010001
10002000000000001100000010001
10000000E00000001101010010001
1100000111010101111101111000111
11110111 1110101 101111010001
11111111 1111111 111111111111