
NO pics/mondriansm.xpm
R 640		  	320

WE 	   pics/marilynsm.xpm
S	pics/davincism.xpm			
SO      	pics/pollocksm.xpm	
F	30,100,40  	

EA pics/picassosm.xpm

C 55,130,190


        1111111111111111111111111
        10000000001100000000S0001
        1011000001110000200020001
        1001000000000000000000001
111111111011000001110000010220001
100000000011000001110111110111111
11110111111111011100000010001
11110111111111011101010010001
11000000110101011100000010001
10002000000000001100000010001
10000000000000001101010010001
1100000111010101111101111000111
11110111 1110101 101111010001
11111111 1111111 111111111111