   R 640		  	320
EA pics/eagle.xpm

	NO pics/mondriansm.xpm
WE 	   pics/purplestone.xpm
	  SO      	pics/redbrick.xpm	
S	  pics/barrel.xpm			
F	100,100,100  	


C 0 , 50 , 50
 
       11111111111111111111111111111111111111111111111111111
       10000000000000000000000000000000000000000000000000001
       10000000000000000000000000000000000000000000000000001
       10000000000000000000000000000000000000000200000000001
       10000000000000011111111110000000000000000000000000001
       1000000000000001        10000000000000000000000000001
       1000000000000001        10000000000000000000000000001
       1000000000000001        10000000000000000000000000001
       1000000000000001        10000000000000000000000000011
       1000000000000001111111111000000000000000000000000001
       10000000000000000000000000000000000000000000000000011
       10000000000000000000000000000000000000000000000000001
       10000000000000000000000000000000000000000000000000001
       10000000000000000000000020000000000000000000000000001
       10000000000000000000000000000000000000000000000000001
       10000000200000000000000000000000000000011111111111111
       1000000000000000000000000000000000000001
       10000000000000000000000000000000000000011
       10000000000000000000000000000000200000001
       10000000000000000000000000000000000000011
       1000000000000000000111111111110000000001
       10000000000000000001         11000000001
       10000000000000000001          1000000001
       10000000000000000001          1000000001
       10000000000000000001          1000200001
       10000000000000000001          1000000001
       10000000000000000001          1000000001
       10000000000000000001          1000000001
       10000000000000000001          10000000011
       10000000000000000001          10000000001111111111
       10000000000000000001          1000000000000000W001
       11111111111111111111          11111111111111111111